                      #                    |
                     G                     |
    |                                      |
S       |                                  |
||||||||||||||||||||||||||||||||||||||||||||